border_size=1
usage=map

Gg, Gg, Gg, Gg, Gg, Gg, Gg
Gg, Gg, Gg, Gg, 1 Kh, Gg, Gg
Gg, Gg, Gg, Ch, Ch, Ch, Gg
Gg, Ch, Ch, Ch, Gg, Gg, Gg
Gg, Ch, 2 Gg, Ch, Gg, Gg, Gg
Gg, Ch, Ch, Ch, Gg, Gg, Gg
Gg, Gg, Gg, Gg, Gg, Gg, Gg
